11111111
1P00C001
11111101
1V000001
10C1C1C1
10111111
1C00C0E1
11111111