1111111111
1P001E0111
10C0110111
1V00000101
1001110111
1C01000111
10010C0111
1111111111