1111111111111
10C110C011C01
10000000000V1
1001101111001
1P0C1C00C1001
1E011111000C1
1111111111111