11111111
1P000001
111111C1
1V000001
10111001
1000C0E1
11111111