1111111111
1P00000001
1CCCCCCCC1
1CCCCCCCC1
10000000E1
1111111111