1111111111111111111
1P00000001000000001
1CCCCCCCC1000000001
1CCCCCCCC1000000001
10000000E1000000001
1111111111111111111