1111111111111111111111111111111111111
10000000000000000000000000000000000C1
10E0000C00000111111101111111111111111
100000C00011111111C001111000111111111
100000001111111PC00001000C00111111111
1000011111111C000000000C00001111111C1
1001111111C00000000000000111111110001
10111111C00000000C0000011111110000001
101111C00000C0C000C001111111000000001
1011111111111111111101111111000001111
1011111111111111111101111111000111111
1000000000000111111101111111011111111
100C000000C001111111000C000000000C001
10000000000C011111110000000C000000001
1111111111111111111111111111111111111