11111111
1P001EV1
10C01101
10000001
10011101
1C010001
10010C01
1111 111