11111111111
100000000P1
10011111101
100100C0001
10010000001
1V0100C0001
1CC10000001
1CC100C0001
1CC100000E1
11111111111