11111111
1P001EV1
10C01101
10000001
1001110
1C010001
10010C01
11111111