11111
1P1E1
10101
10001
10V01
10101
101C1
11111