11111111
1P000001
111111C1
10000001
10111V01
1000C0E1
11111111